{
      "name" : "Target",
      "sizeX" : 10,
      "sizeY" : 10,
      "amountOfPlayers" : 4,
      "map" : [
        [1,1,1,1,1,1,1,1,1,1],
        [1,3,2,2,2,2,2,2,3,1],
        [1,2,2,1,2,2,1,2,2,1],
        [1,2,1,2,2,2,2,1,2,1],
        [1,2,2,2,1,1,2,2,2,1],
        [1,2,2,2,1,1,2,2,2,1],
        [1,2,1,2,2,2,2,1,2,1],
        [1,2,2,1,2,2,1,2,2,1],
        [1,3,2,2,2,2,2,2,3,1],
        [1,1,1,1,1,1,1,1,1,1]
      ]
 }