{
  "name": "LvRayAllen2",
  "sizeX": 7,
  "sizeY": 7,
  "amountOfPlayers": 2,
  "map": [
    [ 1, 1, 1, 1, 1, 1, 1 ],
    [ 1, 2, 0, 0, 0, 2, 1 ],
    [ 1, 0, 0, 0, 0, 0, 1 ],
    [ 1, 0, 3, 2, 3, 0, 1 ],
    [ 1, 0, 0, 0, 0, 0, 1 ],
    [ 1, 2, 0, 0, 0, 2, 1 ],
    [ 1, 1, 1, 1, 1, 1, 1 ]
  ]
}