{
  "name" : "Lv2",
  "sizeX" : 15,
  "sizeY" : 13,
  "amountOfPlayers" : 2,
  "map" : [
    [1,1,1,1,1,1,1,1,1,1,1,1,1,1,1],
    [1,0,0,0,0,0,0,0,0,0,0,0,0,0,1],
    [1,0,1,0,1,0,1,0,1,0,1,0,1,0,1],
    [1,0,0,0,0,0,0,0,0,0,0,0,0,0,1],
    [1,0,1,0,1,0,1,0,1,0,1,0,1,0,1],
    [1,0,0,0,0,0,0,0,0,0,0,0,0,0,1],
    [1,0,1,0,1,0,1,0,1,0,1,0,1,0,1],
    [1,0,0,0,0,0,0,0,0,0,0,0,0,0,1],
    [1,0,1,0,1,0,1,0,1,0,1,0,1,0,1],
    [1,0,0,0,0,0,0,0,0,0,0,0,0,0,1],
    [1,0,1,0,1,0,1,0,1,0,1,0,1,0,1],
    [1,0,0,0,0,0,0,0,0,0,0,0,0,0,1],
    [1,1,1,1,1,1,1,1,1,1,1,1,1,1,1]
  ]
}